21
*
21
*
2
*
000-2-0
#
001-2-1
#
002-2-2
#
003-2-3
#
004-2-4
#
005-2-5
#
006-2-6
#
007-2-7
#
008-2-8
#
009-2-9
#
010-2-10
#
011-2-11
#
012-2-20
#
013-2-21
#
014-2-12
#
015-2-13
#
016-2-14
#
017-2-15
#
018-2-16
#
019-2-17
#
020-2-18
#
021-2-19
#
022-2-22
#
023-2-23
#
024-2-30
#
025-2-31
#
026-2-40
#
027-2-41
#
028-2-32
#
029-2-42
#
030-2-33
#
031-2-34
#
032-2-43
#
033-2-44
#
034-2-50
#
035-2-51
#
036-2-60
#
037-2-61
#
038-2-25
#
039-2-26
#
040-2-27
#
041-2-28
#
042-2-29
#
043-2-35
#
044-2-36
#
045-2-37
#
046-2-38
#
047-2-39
#
048-2-45
#
049-2-46
#
050-2-47
#
051-2-48
#
052-2-49
#
053-2-55
#
054-2-56
#
055-2-57
#
056-2-58
#
057-2-59
#
058-2-65
#
059-2-66
#
060-2-67
#
061-2-68
#
062-2-69
#
063-2-70
#
064-2-80
#
065-2-71
#
066-2-81
#
067-2-72
#
068-2-73
#
069-2-82
#
070-2-83
#
071-2-84
#
072-2-85
#
073-2-76
#
074-2-77
#
075-2-86
#
076-2-87
#
077-2-78
#
078-2-79
#
079-2-88
#
080-2-89
*
000000001110110000000
000000011000110000000
000001111111111110000
000001111111111110000
000001110111111100000
000000101101101000000
000000001100110000000
000000001000010000000
000000000000000000000
000000000000000000000
000000100000001000000
001000000000000000100
000000000000000000000
000001000000000100000
100000000000000000001
111100111000111000011
011111111000111111110
000000000000000000000
000000000000000000000
000000000000000000000
111111110000111111111
*
000 000 000 000 000 000 000 010 011 014 015 000 010 011 000 000 000 000 000 000 000
000 000 000 000 000 000 000 012 013 000 000 000 012 013 000 000 000 000 000 000 000
000 000 000 000 010 011 014 015 038 039 040 041 042 014 015 010 011 000 000 000 000
000 000 000 000 012 013 016 000 043 044 045 046 047 022 000 012 013 000 000 000 000
000 000 000 000 014 015 010 011 048 049 050 051 052 010 011 014 015 000 000 000 000
000 000 000 000 000 022 012 013 053 054 055 056 057 012 013 022 000 000 000 000 000
000 000 000 000 000 000 023 000 058 059 060 061 062 016 000 023 000 000 000 000 000 
000 000 000 000 000 000 000 014 015 004 001 005 014 015 000 000 000 000 000 000 000
000 000 000 000 000 000 000 000 000 004 001 005 000 000 000 000 000 000 000 000 000
000 000 000 000 000 000 024 025 000 004 001 005 000 024 025 000 000 000 000 000 000
000 024 025 000 000 000 026 027 000 004 001 005 000 026 027 000 000 000 024 025 000
000 026 027 000 000 000 000 000 000 004 001 005 000 000 000 000 000 000 026 027 000
000 000 000 000 024 025 000 000 000 004 001 005 000 000 000 024 025 000 000 000 000
000 000 000 000 026 027 000 000 000 004 001 005 000 000 000 026 027 000 000 000 000
028 000 000 000 000 000 000 000 000 004 001 005 000 000 000 000 000 000 000 000 028
029 028 030 031 034 035 030 031 028 004 001 005 028 030 031 034 035 034 035 028 029
000 029 032 033 036 037 032 033 029 004 001 005 029 032 033 036 037 036 037 029 000
003 003 003 003 003 003 003 003 003 009 001 008 003 003 003 003 003 003 003 003 003
001 001 001 001 001 001 001 001 001 001 001 001 001 001 001 001 001 001 001 001 001
063 065 067 068 001 001 073 074 001 001 001 001 001 067 068 001 001 073 074 001 001
064 066 069 070 071 072 075 076 077 078 001 079 080 069 070 071 072 075 076 079 080
*
0-575
*
10-6-3.map